     NO    ./path_to_the_north_texture

SO ./path_to_the_south_texture
    WE ./path_to_the_west_texture
EA        ./path_to_the_east_texture



F 220,110,0


C 225,30,0





	111 11111
1111010101
1011010N0111
11 11 1111
