
			NO          ./path_to_the_north_texture

SO ./path_to_the_south_texture

EA   				  ./path_to_the_east_texture


  F 220,110,0


WE ./path_to_the_west_texture

C 225,30,0


  11  1111 1111
  1 110001 1001
111   1101  111
1    11101 1
  111110N111
11111 1111
